g.WWWWWWWWWWWWWWWWWWWW
ggg....WWWWWWWWWWWWWWW
ggg.........ggggg.....
......g.........gggg..
WWWWWW....WWWWWWWWWWWW
WWW.....WWWWWWWWWWWWWW
W.........WWWg.fgWWWWW
WWWWWWWW..ff..ggWWWWWW
WWWWWWWWWWWWWWWWWWWWWW
WWWWWWWWWWWWWWWWWWWWWW
WWWWWWWWWWWWWWWWWWWWWW
WWWWWWWWWWWWWWWWWWWWWW
WWWWWWWWWWWWWWWWWWWWWW
WWWWWWWWWWWWWWWWWWWWWW
WWWWWWWWWWWWWWWWWWWWWW
WWWWWWWWWWWWWWWWWWWWWW
WWWWWWWWWWWWWWWWWWWWWW









