BoF|FFFFFFEFFFFFFFFFFF
BbFF||FFFFFFFFFFFFFFFF
BBBFF|FFFFFFFFFFFEFFFF
BBBBF|________________
BBBBF|FFFFFFFFFFFFFFFF
FFFFFFFbBBBBBBBBBBBBBB
_____|FbbbbbbbbbbbbbbO
FFFFF|FbbbBBBBBBBBBBBB
FFFFF|FFFFFFFFFFFFFFFF
FFFFF|________________
FFFFFFFFFFFFFFFFFFFFFF
FFFFFFFFFFFFFFFFFFFFFF
FFFFFFFFFFFFFFFFFFFFFF
FFFFFEFFFFFFFFFFFFFFFF
FFFFFFFFFFFFFFFFFFFFFE
FFFFFFFFFFFFFFFFFFFFFF
FFFFFFFFFFFFFFFFFFFFFF
