**********************
*********<<<<<<<<*****
**********************
****************d*****
**<<<<[[[[[[[[[<<<<<**
[[[[[*********p*<<<<**
*******#*#<<<<<<<<****
****[[[*****<<<<<<<<<<
[[[[[[[<<<<<<<<<<<,<<<
<<********<<]]<<<<<<<<
*****$**$*<<<<<<<*****
***[[[[[[[[[[[[******|
**********************
*******[[[[[[[[[[[[[[[
************[[[[[[[[[[
**********************
|O^^^*****************
