*v********************
**<<<<***<<<<<<<<****<
**<<<<<*********E***<<
*************v*****<<<
**<<<<***[[****<<<<<<<
[[[[[***********<<<<<<
*******#*#<<<<<<<<<<<<
****[[[*****<<<<<<<<<O
[[[[[[[<<<<<<<<<E<<<<<
<<********<<<<<<<<<<<<
**********E<<<<<<<<***
***[[[[[[[[[[[[*f****|
**********************
*******[*<ff*****[[[[[
*<<<<<******[[[[[[[[[[
***********<*<<*******
**^^^******[[*********
