**********************
**<<<<***<<<<<<<<*****
**<<<<<***************
*************v**d*****
**<<<<***[[****<<<<<**
[[[[[*********p*<<<<*O
*******#*#<<<<<<<<****
****[[[*****<<<<<<<<<<
[[[[[[[<<<<<<<<<<<,<<<
<<********<<<<<<<<<<<<
**********<<<<<<<*****
***[[[[[[[[[[[[******|
**********************
*******[<<<<*****[[[[[
************[[[[[[[[[[
**********************
**^^^*****************
