*v*******<<<<<<<<<<<**
**<<<<***<f<<<<<<****<
**<<<<<*********E***<<
*************v*****<<<
**<<<<***[E****<<<<<<<
[[[[[*****f*****<***<<
*******#__|<<<<<<<<<<<
****[[[***____________
[[[[[[[<<<<<<<<<E<<<<|
<<*****<<<<<********<|
**********E<<<<<<<<**|
***[[|||||__[[[*f****|
*********||**********|
*******[*||f*****[[[[|
*<<<<<***||*[[[[[[[[[|
*********|*<*<<******O
**^^^****|___________|
