ggo.WWWWWWWWWWWWWWWWWW
gfg.WWWWWWWWWWWWWWWWWW
....WWWWWWWWWWWWWWWWWW
WWWWWWWWWWWWWWWWWWWWWW
WWWWWWWWWWWWWgggWWWWWW
WWWWWWWWWWWWgg.fggWWWW
WWWWWWWWWWWWWg.fgWWWWW
WWWWWWWWWWWWWWggWWWWWW
WWWWWWWWWWWWWWWWWWWWWW
WWWWWWWWWWWWWWWWWWWWWW
WWWWWWWWWWWWWWWWWWWWWW
WWWWWWWWWWWWWWWWWWWWWW
WWWWWWWWWWWWWWWWWWWWWW
WWWWWWWWWWWWWWWWWWWWWW
WWWWWWWWWWWWWggggWWWWW
WWWWWWWggggggggggggWWW
WWWWWWWWWgggggOgggggWW
