*v****|***********<<**
*****<|**<f<<<<<<****<
**<<<<|*********E***<<
___**********v*****<**
**<<<<***[E****<<<<<<<
**********f*****<***<<
*******#__<<<<<<<<<<<<
***********___________
[****[[<<<<<<<<<E<<<<|
<<*****<<<<<********<|
**********E<<<<<<<<**|
***[[|||||[[[[[*f****|
*********|f**********|
*******[*|ff*****[[[[|
*****<E**|**[*****[[[|
*********|*<*<<******O
*********|___________|
